,Aktion_0,Aktion_1,Aktion_2,Aktion_3,Aktion_4,Aktion_5,Duration,Reward
Expert,45,62,4,22,25,4,162,611.0
Expert,34,116,24,49,63,10,296,2196.0
Expert,53,133,21,122,17,22,368,3610.0
Expert,43,112,9,42,42,14,262,2250.0
Expert,44,125,18,55,50,13,305,3802.0
Expert,55,198,33,99,158,31,574,7289.0
Expert,45,132,22,58,52,22,331,2979.0
Expert,38,83,12,51,29,11,224,854.0
Expert,67,186,23,79,117,14,486,6207.0
Expert,46,154,57,109,116,19,501,5448.0
Expert,43,109,16,43,40,10,261,4462.0
Expert,35,123,7,59,40,18,282,6698.0
Expert,176,0,14,77,81,11,359,3514.0
Expert,76,29,125,32,25,48,335,165.0
Expert,34,46,6,18,17,2,123,1681.0
Expert,36,178,18,57,60,12,361,6009.0
Expert,68,372,29,93,100,30,692,2026.0
Expert,41,97,5,27,26,4,200,1294.0
Expert,47,245,13,63,58,11,437,5501.0
Expert,44,237,15,59,58,16,429,2218.0
Expert,40,99,11,24,24,6,204,5854.0
Expert,50,313,19,79,75,13,549,5400.0
Expert,129,0,147,51,50,116,493,637.0
Expert,61,169,14,49,44,13,350,4663.0
Expert,59,271,35,79,78,27,549,3175.0
Expert,47,206,25,42,39,16,375,8442.0
Expert,60,306,23,81,78,17,565,5818.0
Expert,41,282,21,76,77,17,514,3395.0
Expert,43,185,9,47,44,13,341,2374.0
Expert,48,159,15,30,24,19,295,4307.0
Expert,44,166,16,50,43,15,334,2956.0
Expert,50,110,38,36,35,33,302,9061.0
Expert,51,171,27,40,39,18,346,2608.0
Expert,70,239,22,66,66,16,479,7638.0
Expert,41,31,7,10,17,3,109,7357.0
Expert,45,256,22,68,52,17,460,1673.0
Expert,53,179,13,49,41,16,351,6085.0
Expert,39,219,14,64,62,14,412,4425.0
Expert,62,340,19,71,65,17,574,4888.0
Expert,45,153,19,35,32,10,294,12538.0
Expert,55,155,18,39,38,16,321,3396.0
Expert,96,395,41,104,108,40,784,1851.0
Expert,66,243,30,67,66,20,492,4047.0
Expert,64,226,22,76,77,19,484,3130.0
Expert,50,229,24,69,72,22,466,4797.0
Expert,59,165,24,67,65,16,396,4950.0
Expert,45,138,14,36,39,15,287,3293.0
Expert,61,277,27,91,88,23,567,4067.0
Expert,63,259,17,76,81,19,515,11596.0
Expert,55,200,22,67,63,18,425,6235.0
Expert,72,220,28,63,72,21,476,7062.0
Expert,41,80,11,28,34,11,205,3296.0
DDQN_1Mio,54,55,0,23,25,1,158,3045.0
DDQN_1Mio,88,97,0,72,66,2,325,8559.0
DDQN_1Mio,91,101,0,84,66,9,351,8304.0
DDQN_1Mio,293,83,13,65,44,4,502,6815.0
DDQN_1Mio,85,42,0,18,26,0,171,2031.0
DDQN_1Mio,81,64,0,44,56,4,249,5339.0
DDQN_1Mio,55,38,0,32,37,1,163,1808.0
DDQN_1Mio,98,115,0,44,58,0,315,5170.0
DDQN_1Mio,85,102,0,44,43,1,275,4712.0
DDQN_1Mio,71,115,2,36,30,5,259,2966.0
DDQN_1Mio,80,53,0,49,74,1,257,4451.0
DDQN_1Mio,50,41,4,20,24,0,139,234.0
DDQN_1Mio,230,127,0,105,118,1,581,12874.0
DDQN_1Mio,75,99,0,54,55,1,284,6169.0
DDQN_1Mio,122,117,1,77,81,5,403,8806.0
DDQN_1Mio,76,77,0,65,54,0,272,4710.0
DDQN_1Mio,103,77,5,78,50,0,313,6951.0
DDQN_1Mio,110,83,0,66,61,3,323,5405.0
DDQN_1Mio,64,78,0,58,58,1,259,3894.0
DDQN_1Mio,95,190,0,35,30,0,350,7188.0
DDQN_1Mio,136,66,2,40,29,0,273,5729.0
DDQN_1Mio,72,96,0,62,84,6,320,7109.0
DDQN_1Mio,67,126,0,43,59,6,301,6873.0
DDQN_1Mio,136,52,0,52,62,8,310,7340.0
DDQN_1Mio,103,188,0,167,165,5,628,14832.0
DDQN_1Mio,114,57,3,40,40,0,254,5529.0
DDQN_1Mio,107,77,0,70,61,1,316,8151.0
DDQN_1Mio,119,85,0,32,34,0,270,4237.0
DDQN_1Mio,127,47,1,49,27,0,251,4550.0
DDQN_1Mio,68,72,0,65,67,2,274,5891.0
DDQN,0,275,0,0,0,0,275,3384.0
DDQN,0,277,0,0,0,0,277,3384.0
DDQN,0,275,0,0,0,0,275,3384.0
DDQN,0,277,0,0,0,0,277,3384.0
DDQN,0,276,0,0,0,0,276,3384.0
DDQN,0,279,0,0,0,0,279,3384.0
DDQN,0,274,0,0,0,0,274,3384.0
DDQN,0,279,0,0,0,0,279,3384.0
DDQN,0,274,0,0,0,0,274,3384.0
DDQN,0,278,0,0,0,0,278,3384.0
DDQN,0,274,0,0,0,0,274,3384.0
DDQN,0,275,0,0,0,0,275,3384.0
DDQN,0,275,0,0,0,0,275,3384.0
DDQN,0,278,0,0,0,0,278,3384.0
DDQN,0,278,0,0,0,0,278,3384.0
DDQN,0,279,0,0,0,0,279,3384.0
DDQN,0,279,0,0,0,0,279,3384.0
DDQN,0,277,0,0,0,0,277,3384.0
DDQN,0,396,0,1,0,0,397,5406.0
DDQN,0,279,0,0,0,0,279,3384.0
DDQN,0,277,0,0,0,0,277,3384.0
DDQN,0,275,0,0,0,0,275,3384.0
DDQN,0,276,0,0,0,0,276,3384.0
DDQN,0,279,0,0,0,0,279,3384.0
DDQN,0,274,0,0,0,0,274,3384.0
DDQN,0,277,0,0,0,0,277,3384.0
DDQN,0,247,0,1,0,0,248,2611.0
DDQN,0,348,0,2,0,0,350,5373.0
DDQN,0,279,0,0,0,0,279,3384.0
DDQN,0,278,0,0,0,0,278,3384.0
Agent_78,106,200,4,28,12,0,350,3717.0
Agent_78,95,225,4,21,10,1,356,2518.0
Agent_78,31,148,2,15,5,1,202,1316.0
Agent_78,6,250,2,7,6,0,271,2817.0
Agent_78,68,199,2,15,7,3,294,1605.0
Agent_78,73,375,3,44,22,4,521,5027.0
Agent_78,33,363,4,86,22,13,521,7042.0
Agent_78,45,221,1,15,5,1,288,4080.0
Agent_78,36,323,4,50,25,5,443,4864.0
Agent_78,32,295,3,19,3,6,358,5680.0
Agent_78,71,196,1,28,12,2,310,1447.0
Agent_78,62,229,7,19,20,15,352,4574.0
Agent_78,45,209,2,19,8,0,283,3282.0
Agent_78,52,351,4,22,21,4,454,3764.0
Agent_78,55,208,0,10,12,11,296,2495.0
Agent_78,61,171,0,24,4,0,260,3089.0
Agent_78,4,344,1,3,1,10,363,8491.0
Agent_78,25,157,0,4,1,0,187,1346.0
Agent_78,75,262,3,28,7,5,380,1456.0
Agent_78,26,207,3,14,4,0,254,2566.0
Agent_78,118,305,3,36,28,6,496,4603.0
Agent_78,66,210,16,38,12,7,349,2449.0
Agent_78,68,158,3,64,33,14,340,1051.0
Agent_78,51,235,1,11,3,2,303,2867.0
Agent_78,43,279,2,16,7,0,347,2564.0
Agent_78,50,134,1,13,5,0,203,1919.0
Agent_78,61,226,0,15,9,5,316,2607.0
Agent_78,60,212,5,25,4,1,307,3097.0
Agent_78,72,174,2,53,10,1,312,2828.0
Agent_78,17,305,2,3,8,4,339,7825.0
Agent_82,15,428,1,25,8,1,478,5395.0
Agent_82,18,423,6,67,13,2,529,7806.0
Agent_82,31,269,4,35,5,0,344,2599.0
Agent_82,24,243,1,105,25,1,399,3253.0
Agent_82,33,298,1,30,5,0,367,1879.0
Agent_82,50,152,2,47,9,1,261,1386.0
Agent_82,14,336,1,62,9,0,422,5393.0
Agent_82,73,263,1,51,3,0,391,4661.0
Agent_82,27,196,3,98,1,0,325,2231.0
Agent_82,19,159,3,9,5,0,195,902.0
Agent_82,47,254,2,16,5,1,325,3810.0
Agent_82,30,220,2,31,5,0,288,2098.0
Agent_82,12,158,2,10,4,0,186,651.0
Agent_82,17,321,4,54,16,0,412,4331.0
Agent_82,43,170,1,24,5,0,243,1615.0
Agent_82,11,384,9,48,8,5,465,5222.0
Agent_82,17,168,1,16,2,0,204,3441.0
Agent_82,22,283,4,18,4,2,333,3299.0
Agent_82,2,175,1,23,2,0,203,1718.0
Agent_82,8,137,2,12,4,0,163,1774.0
Agent_82,1,357,3,33,4,0,398,6816.0
Agent_82,29,228,1,38,6,0,302,3113.0
Agent_82,76,215,3,48,12,0,354,2691.0
Agent_82,43,246,3,42,10,0,344,3923.0
Agent_82,1,213,2,4,2,0,222,3121.0
Agent_82,59,299,8,73,15,0,454,2867.0
Agent_82,17,176,2,28,7,0,230,2937.0
Agent_82,62,156,2,21,4,0,245,3880.0
Agent_82,13,250,1,20,7,0,291,1046.0
Agent_82,29,430,2,75,12,3,551,5222.0
Agent_88,1,198,0,4,1,0,204,1321.0
Agent_88,26,250,1,4,6,0,287,1201.0
Agent_88,28,251,0,6,2,0,287,3134.0
Agent_88,55,336,0,5,8,0,404,5277.0
Agent_88,5,559,1,24,25,2,616,14541.0
Agent_88,44,412,1,17,13,1,488,5018.0
Agent_88,30,266,2,1,6,0,305,4389.0
Agent_88,40,208,0,7,1,0,256,2060.0
Agent_88,39,257,1,12,32,0,341,4722.0
Agent_88,39,275,1,8,5,0,328,5032.0
Agent_88,61,251,1,20,7,0,340,6351.0
Agent_88,16,386,1,21,13,1,438,5243.0
Agent_88,52,239,1,6,8,0,306,3394.0
Agent_88,46,279,2,24,10,0,361,4279.0
Agent_88,84,336,2,32,31,0,485,6085.0
Agent_88,59,432,1,18,14,0,524,4946.0
Agent_88,33,227,2,14,4,0,280,3115.0
Agent_88,33,208,1,10,7,0,259,3981.0
Agent_88,56,215,2,28,11,0,312,2791.0
Agent_88,102,300,0,18,8,0,428,4442.0
Agent_88,1,374,0,2,2,0,379,5066.0
Agent_88,44,177,2,4,5,0,232,3910.0
Agent_88,28,204,0,8,1,0,241,3399.0
Agent_88,41,174,2,5,3,0,225,2390.0
Agent_88,8,200,1,4,3,0,216,1689.0
Agent_88,27,174,2,9,5,0,217,1189.0
Agent_88,57,229,1,10,2,0,299,3338.0
Agent_88,61,416,4,30,37,3,551,5908.0
Agent_88,20,139,1,8,2,0,170,927.0
Agent_88,75,411,1,8,14,3,512,5583.0
Agent_89,50,203,3,7,7,0,270,2485.0
Agent_89,95,213,3,13,3,0,327,4462.0
Agent_89,56,162,4,14,3,0,239,889.0
Agent_89,73,247,5,4,6,0,335,4834.0
Agent_89,96,391,4,14,8,0,513,10093.0
Agent_89,73,103,4,0,3,0,183,1262.0
Agent_89,36,170,4,2,3,0,215,2217.0
Agent_89,82,238,4,8,6,0,338,3394.0
Agent_89,50,258,3,6,3,0,320,2376.0
Agent_89,37,138,4,8,3,0,190,1202.0
Agent_89,56,244,5,13,3,0,321,3128.0
Agent_89,66,449,4,7,6,0,532,4723.0
Agent_89,85,182,4,14,6,0,291,1277.0
Agent_89,49,153,4,8,4,0,218,1974.0
Agent_89,102,215,3,13,2,0,335,2637.0
Agent_89,150,249,3,14,7,0,423,5151.0
Agent_89,118,286,3,13,4,0,424,5551.0
Agent_89,98,313,3,7,3,0,424,3593.0
Agent_89,94,153,5,5,2,0,259,2704.0
Agent_89,105,171,4,1,4,0,285,1475.0
Agent_89,78,260,9,10,12,1,370,5175.0
Agent_89,60,183,2,7,3,0,255,2737.0
Agent_89,82,206,2,5,3,0,298,2964.0
Agent_89,59,383,5,35,26,2,510,3544.0
Agent_89,15,147,4,3,3,0,172,1024.0
Agent_89,47,176,2,5,3,0,233,4763.0
Agent_89,54,231,4,7,4,0,300,3598.0
Agent_89,70,172,10,1,4,1,258,3950.0
Agent_89,66,134,4,16,5,8,233,1438.0
Agent_89,52,254,4,11,5,0,326,2456.0
Agent_198,34,201,10,12,8,0,265,2478.0
Agent_198,67,69,10,1,7,0,154,2233.0
Agent_198,45,209,13,4,8,0,279,1200.0
Agent_198,43,198,12,7,7,0,267,1395.0
Agent_198,44,193,6,7,7,0,257,1335.0
Agent_198,42,174,16,9,9,0,250,2476.0
Agent_198,39,172,11,12,8,0,242,2883.0
Agent_198,59,199,9,5,5,0,277,4109.0
Agent_198,44,132,11,3,9,0,199,2324.0
Agent_198,54,257,8,18,9,0,346,5504.0
Agent_198,34,221,12,7,4,0,278,2677.0
Agent_198,34,169,9,12,9,0,233,650.0
Agent_198,54,135,13,1,4,0,207,2702.0
Agent_198,42,255,15,8,8,0,328,4498.0
Agent_198,45,84,8,3,7,0,147,1141.0
Agent_198,42,179,10,4,6,0,241,2867.0
Agent_198,43,201,17,7,5,0,273,2736.0
Agent_198,53,159,8,5,6,0,231,3685.0
Agent_198,53,133,14,1,6,0,207,3337.0
Agent_198,38,165,5,10,10,0,228,2974.0
Agent_198,43,160,9,4,7,0,223,2202.0
Agent_198,33,326,11,5,8,0,383,4295.0
Agent_198,43,241,10,35,8,0,337,3272.0
Agent_198,58,181,9,0,7,0,255,3020.0
Agent_198,86,328,10,7,6,0,437,4938.0
Agent_198,41,262,15,13,11,0,342,4833.0
Agent_198,50,320,13,11,25,0,419,5650.0
Agent_198,54,413,9,9,5,0,490,4212.0
Agent_198,36,216,17,4,8,0,281,3911.0
Agent_198,55,130,8,7,8,0,208,1896.0
Agent_297,44,344,4,44,33,5,474,6010.0
Agent_297,49,419,4,36,32,3,543,7620.0
Agent_297,52,236,2,16,23,0,329,5424.0
Agent_297,52,203,4,5,9,0,273,2418.0
Agent_297,49,150,2,10,10,0,221,2142.0
Agent_297,37,239,8,28,30,1,343,3217.0
Agent_297,31,115,3,6,11,1,167,2428.0
Agent_297,49,140,3,11,14,0,217,1705.0
Agent_297,41,165,4,21,16,1,248,3880.0
Agent_297,43,173,2,7,19,0,244,1427.0
Agent_297,46,135,3,10,8,4,206,2042.0
Agent_297,44,277,2,15,14,0,352,2889.0
Agent_297,37,71,3,5,7,1,124,1148.0
Agent_297,48,190,4,5,11,0,258,2562.0
Agent_297,45,219,2,31,15,1,313,2737.0
Agent_297,50,123,3,6,8,0,190,797.0
Agent_297,37,150,1,9,7,0,204,1460.0
Agent_297,41,308,6,23,32,2,412,4513.0
Agent_297,46,204,7,58,29,0,344,3943.0
Agent_297,40,190,2,21,11,0,264,1304.0
Agent_297,38,207,5,11,12,0,273,1685.0
Agent_297,41,153,2,3,14,0,213,698.0
Agent_297,39,165,2,7,9,0,222,2051.0
Agent_297,47,162,4,8,13,0,234,1323.0
Agent_297,61,456,4,43,34,4,602,10096.0
Agent_297,36,300,2,24,22,0,384,4000.0
Agent_297,51,348,1,17,14,0,431,4730.0
Agent_297,39,212,3,26,29,1,310,4361.0
Agent_297,54,255,3,70,35,1,418,5369.0
Agent_297,43,342,8,15,12,0,420,4341.0
Agent_298,54,333,1,43,23,2,456,3808.0
Agent_298,38,129,2,11,16,0,196,601.0
Agent_298,41,299,2,27,27,0,396,3591.0
Agent_298,56,206,8,7,14,6,297,2680.0
Agent_298,50,138,3,12,13,3,219,1585.0
Agent_298,40,280,11,35,24,0,390,2041.0
Agent_298,53,131,1,15,15,0,215,2431.0
Agent_298,46,295,9,13,18,1,382,2114.0
Agent_298,45,243,3,33,30,1,355,4548.0
Agent_298,47,240,4,42,33,1,367,3847.0
Agent_298,78,385,3,6,29,0,501,3460.0
Agent_298,61,388,2,52,35,0,538,5572.0
Agent_298,38,236,2,36,29,0,341,4290.0
Agent_298,60,193,2,0,21,0,276,2345.0
Agent_298,39,122,3,11,21,0,196,1063.0
Agent_298,56,231,5,10,12,0,314,2067.0
Agent_298,77,451,8,5,18,0,559,3255.0
Agent_298,44,193,5,12,24,4,282,4287.0
Agent_298,78,265,8,8,15,1,375,5143.0
Agent_298,45,251,3,24,22,1,346,3517.0
Agent_298,43,215,2,21,9,1,291,1789.0
Agent_298,58,302,4,31,25,2,422,4525.0
Agent_298,53,428,6,27,48,2,564,7725.0
Agent_298,38,217,4,39,16,0,314,2769.0
Agent_298,53,190,9,15,25,0,292,2434.0
Agent_298,70,84,1,4,8,0,167,2704.0
Agent_298,38,193,9,30,25,1,296,2763.0
Agent_298,51,229,6,1,18,2,307,2676.0
Agent_298,41,427,5,14,30,10,527,5104.0
Agent_298,37,268,7,13,32,0,357,4050.0
Agent_311,40,168,7,16,14,1,246,3700.0
Agent_311,37,193,5,18,11,3,267,1175.0
Agent_311,41,365,9,34,19,5,473,7006.0
Agent_311,39,266,6,49,38,11,409,7812.0
Agent_311,34,96,4,13,10,0,157,1604.0
Agent_311,39,122,4,11,11,0,187,1436.0
Agent_311,39,199,5,23,8,1,275,1999.0
Agent_311,40,301,5,44,25,18,433,4942.0
Agent_311,42,311,6,41,37,10,447,5359.0
Agent_311,39,368,10,42,50,6,515,4272.0
Agent_311,28,193,9,42,32,0,304,1686.0
Agent_311,38,114,5,7,7,0,171,560.0
Agent_311,31,292,8,33,22,5,391,3280.0
Agent_311,33,98,5,10,17,2,165,723.0
Agent_311,38,110,5,18,15,0,186,1511.0
Agent_311,32,191,4,15,25,1,268,2946.0
Agent_311,34,410,6,39,33,7,529,3248.0
Agent_311,34,102,4,27,25,1,193,2577.0
Agent_311,42,319,10,14,14,0,399,3750.0
Agent_311,40,143,4,16,15,4,222,3478.0
Agent_311,37,271,3,13,21,0,345,1730.0
Agent_311,39,204,10,22,14,2,291,2992.0
Agent_311,32,98,6,24,12,0,172,1445.0
Agent_311,45,330,6,58,28,4,471,5900.0
Agent_311,35,293,6,39,27,11,411,6486.0
Agent_311,30,197,7,28,17,0,279,3757.0
Agent_311,48,353,5,62,53,2,523,5747.0
Agent_311,32,96,5,17,13,0,163,1266.0
Agent_311,35,335,11,35,23,3,442,5416.0
Agent_311,40,62,3,18,14,0,137,1636.0
Agent_312,46,334,11,10,22,7,430,6257.0
Agent_312,43,427,5,32,48,13,568,8882.0
Agent_312,39,163,7,26,18,4,257,1279.0
Agent_312,53,392,2,29,42,9,527,5104.0
Agent_312,41,273,7,18,30,4,373,6064.0
Agent_312,48,325,7,36,51,10,477,4590.0
Agent_312,42,298,3,31,59,3,436,1767.0
Agent_312,42,202,4,7,13,4,272,2127.0
Agent_312,37,196,4,12,23,4,276,1465.0
Agent_312,45,165,4,7,12,0,233,3612.0
Agent_312,57,220,2,21,26,0,326,5217.0
Agent_312,41,378,6,47,55,19,546,7790.0
Agent_312,42,171,3,10,23,2,251,1916.0
Agent_312,41,163,4,9,15,1,233,772.0
Agent_312,36,306,7,19,18,4,390,2972.0
Agent_312,46,195,6,9,22,0,278,2772.0
Agent_312,35,161,4,15,18,2,235,1072.0
Agent_312,54,400,4,10,24,3,495,3771.0
Agent_312,33,207,2,13,20,7,282,3378.0
Agent_312,47,95,3,10,20,0,175,1632.0
Agent_312,40,300,7,12,43,7,409,1530.0
Agent_312,33,261,3,26,43,8,374,4077.0
Agent_312,37,143,4,11,15,0,210,1755.0
Agent_312,37,165,4,8,14,0,228,3214.0
Agent_312,48,345,4,19,25,7,448,5418.0
Agent_312,37,364,4,22,53,16,496,5720.0
Agent_312,39,204,3,9,16,2,273,3734.0
Agent_312,41,316,9,17,47,1,431,3005.0
Agent_312,45,508,8,14,22,9,606,7695.0
Agent_312,47,161,6,9,8,0,231,1372.0
Agent_317,32,213,6,4,6,8,269,2706.0
Agent_317,42,235,5,15,13,1,311,3382.0
Agent_317,30,264,7,5,10,1,317,5506.0
Agent_317,42,315,7,9,5,0,378,4056.0
Agent_317,40,78,3,2,8,0,131,1082.0
Agent_317,38,350,4,7,7,4,410,5727.0
Agent_317,40,154,4,4,5,0,207,948.0
Agent_317,43,316,14,6,6,0,385,6141.0
Agent_317,35,294,4,1,7,1,342,3520.0
Agent_317,33,226,8,10,15,0,292,4548.0
Agent_317,29,211,5,8,13,2,268,2111.0
Agent_317,42,367,2,11,14,4,440,6452.0
Agent_317,39,67,3,3,6,0,118,706.0
Agent_317,33,146,7,3,7,0,196,638.0
Agent_317,35,158,6,9,9,2,219,1518.0
Agent_317,32,124,5,6,8,0,175,1769.0
Agent_317,42,358,4,11,17,2,434,6504.0
Agent_317,40,272,8,3,5,1,329,3887.0
Agent_317,33,173,5,9,10,1,231,1771.0
Agent_317,43,364,4,5,7,10,433,6771.0
Agent_317,35,316,6,6,5,0,368,3987.0
Agent_317,39,201,4,8,7,1,260,3463.0
Agent_317,32,251,7,4,5,0,299,3091.0
Agent_317,42,275,7,2,5,1,332,6725.0
Agent_317,32,389,2,10,9,3,445,6617.0
Agent_317,41,204,4,9,12,2,272,2914.0
Agent_317,40,161,3,10,8,0,222,1541.0
Agent_317,29,327,5,8,10,2,381,3365.0
Agent_317,26,284,3,17,10,6,346,4217.0
Agent_317,34,265,3,9,8,2,321,3788.0
Agent_318,47,370,5,5,9,1,437,3609.0
Agent_318,38,208,4,0,6,0,256,2306.0
Agent_318,37,167,5,11,4,2,226,2517.0
Agent_318,34,176,4,2,5,2,223,882.0
Agent_318,37,131,5,1,6,1,181,796.0
Agent_318,40,246,6,3,5,3,303,3045.0
Agent_318,48,287,5,4,7,1,352,4245.0
Agent_318,33,368,3,3,8,5,420,5246.0
Agent_318,49,213,11,0,1,6,280,4976.0
Agent_318,40,173,4,3,5,2,227,2407.0
Agent_318,47,572,2,30,21,8,680,11651.0
Agent_318,43,273,6,5,9,0,336,5866.0
Agent_318,51,264,5,0,3,0,323,4339.0
Agent_318,37,134,4,4,5,0,184,1328.0
Agent_318,47,300,3,8,13,3,374,6960.0
Agent_318,34,145,7,3,8,1,198,455.0
Agent_318,53,279,6,3,10,2,353,7273.0
Agent_318,39,375,7,7,8,0,436,4247.0
Agent_318,39,237,8,2,3,4,293,3969.0
Agent_318,39,220,3,2,6,0,270,2260.0
Agent_318,44,222,7,5,4,2,284,2054.0
Agent_318,51,195,6,1,5,0,258,4050.0
Agent_318,37,308,4,5,6,0,360,5108.0
Agent_318,41,120,5,2,6,0,174,1321.0
Agent_318,39,249,7,4,4,2,305,2101.0
Agent_318,36,290,6,3,10,1,346,3840.0
Agent_318,36,314,6,6,10,1,373,3554.0
Agent_318,36,212,3,9,7,2,269,3892.0
Agent_318,57,253,4,0,3,5,322,7445.0
Agent_318,41,291,3,3,9,2,349,5176.0
Agent_319,41,238,6,0,1,0,286,3139.0
Agent_319,39,202,4,1,3,0,249,1619.0
Agent_319,47,217,10,3,3,1,281,3237.0
Agent_319,45,199,6,1,4,4,259,3563.0
Agent_319,45,243,7,7,2,1,305,4827.0
Agent_319,47,278,6,1,3,0,335,4484.0
Agent_319,51,176,5,0,2,0,234,2894.0
Agent_319,39,262,7,1,0,0,309,2780.0
Agent_319,40,161,6,0,3,1,211,2243.0
Agent_319,57,211,7,0,2,1,278,7161.0
Agent_319,50,243,5,1,2,0,301,6800.0
Agent_319,45,206,7,0,1,0,259,3471.0
Agent_319,38,183,7,0,3,1,232,2078.0
Agent_319,34,232,8,0,1,0,275,5203.0
Agent_319,44,150,6,1,0,2,203,1918.0
Agent_319,48,140,9,0,2,0,199,3811.0
Agent_319,38,180,8,0,2,0,228,1381.0
Agent_319,49,213,7,4,4,6,283,4668.0
Agent_319,44,289,11,0,3,1,348,5183.0
Agent_319,47,190,12,1,0,0,250,3998.0
Agent_319,44,268,10,1,2,0,325,3512.0
Agent_319,47,259,10,2,0,4,322,5697.0
Agent_319,50,170,3,0,3,1,227,1750.0
Agent_319,48,332,6,0,1,0,387,4426.0
Agent_319,38,197,7,0,1,0,243,2520.0
Agent_319,37,347,5,0,3,0,392,2005.0
Agent_319,41,227,4,5,2,4,283,1960.0
Agent_319,43,212,7,0,1,2,265,2437.0
Agent_319,38,220,9,1,0,1,269,2220.0
Agent_319,48,134,6,0,1,0,189,1503.0
Agent_329,36,227,3,7,4,0,277,2081.0
Agent_329,45,162,6,2,5,0,220,1509.0
Agent_329,59,254,17,6,8,0,344,4747.0
Agent_329,46,350,8,5,7,1,417,4803.0
Agent_329,68,261,10,8,8,0,355,4642.0
Agent_329,51,190,29,6,7,1,284,4533.0
Agent_329,61,313,14,4,8,0,400,4490.0
Agent_329,68,223,7,6,9,0,313,3696.0
Agent_329,43,184,4,4,4,0,239,3146.0
Agent_329,40,213,5,6,7,0,271,3506.0
Agent_329,41,282,11,5,6,0,345,2785.0
Agent_329,42,168,3,5,8,0,226,2209.0
Agent_329,40,98,8,5,6,0,157,488.0
Agent_329,44,200,10,7,4,1,266,2569.0
Agent_329,41,166,5,8,9,1,230,2327.0
Agent_329,42,179,3,6,5,0,235,1999.0
Agent_329,44,167,5,5,6,2,229,3122.0
Agent_329,45,134,3,8,6,0,196,1116.0
Agent_329,46,288,4,6,8,0,352,4903.0
Agent_329,62,277,4,3,7,0,353,6007.0
Agent_329,43,122,9,2,10,0,186,2339.0
Agent_329,35,114,3,3,7,0,162,975.0
Agent_329,48,307,5,7,7,0,374,4987.0
Agent_329,51,146,19,0,3,1,220,3183.0
Agent_329,37,166,7,7,4,0,221,944.0
Agent_329,52,129,3,6,6,0,196,2002.0
Agent_329,44,163,11,5,5,0,228,1890.0
Agent_329,41,235,4,8,11,0,299,3202.0
Agent_329,41,75,7,5,6,0,134,785.0
Agent_329,57,178,4,5,9,0,253,1706.0
Agent_355,34,103,6,7,8,5,163,1185.0
Agent_355,38,238,12,12,8,3,311,4501.0
Agent_355,42,129,13,7,4,0,195,3081.0
Agent_355,40,266,7,17,15,2,347,3078.0
Agent_355,47,460,16,11,7,0,541,7395.0
Agent_355,50,135,10,6,7,1,209,2204.0
Agent_355,39,142,5,4,7,1,198,1407.0
Agent_355,43,402,7,4,8,3,467,5192.0
Agent_355,43,204,8,6,7,0,268,1278.0
Agent_355,35,115,4,2,7,0,163,944.0
Agent_355,44,357,9,7,8,4,429,4693.0
Agent_355,49,165,8,5,11,0,238,3374.0
Agent_355,48,206,6,10,9,0,279,3818.0
Agent_355,36,108,5,10,9,0,168,1183.0
Agent_355,45,215,8,9,8,0,285,4497.0
Agent_355,34,220,4,9,8,1,276,2640.0
Agent_355,50,249,9,4,7,1,320,2958.0
Agent_355,46,175,4,6,5,1,237,1560.0
Agent_355,46,204,10,8,6,2,276,2745.0
Agent_355,36,223,7,9,7,3,285,1318.0
Agent_355,38,218,8,9,7,0,280,2705.0
Agent_355,37,105,4,6,8,4,164,1808.0
Agent_355,28,284,10,8,7,1,338,1168.0
Agent_355,56,216,11,9,10,1,303,4315.0
Agent_355,44,310,7,16,14,5,396,4519.0
Agent_355,45,320,18,8,9,1,401,6361.0
Agent_355,32,235,7,10,6,0,290,2268.0
Agent_355,43,116,10,1,6,0,176,1261.0
Agent_355,35,202,8,8,7,3,263,2887.0
Agent_355,31,140,12,6,5,0,194,1166.0
Agent_404,56,272,6,17,16,0,367,3961.0
Agent_404,47,147,4,12,11,0,221,1384.0
Agent_404,52,307,2,17,12,0,390,4040.0
Agent_404,56,136,3,24,17,0,236,2113.0
Agent_404,50,288,7,18,19,0,382,6663.0
Agent_404,46,183,2,25,22,0,278,3128.0
Agent_404,40,181,3,20,19,2,265,1798.0
Agent_404,40,236,4,26,21,0,327,2395.0
Agent_404,87,363,3,24,15,0,492,5557.0
Agent_404,54,250,5,18,16,0,343,4480.0
Agent_404,45,144,3,11,10,0,213,1093.0
Agent_404,72,433,8,26,27,1,567,13073.0
Agent_404,59,170,5,17,13,0,264,2697.0
Agent_404,44,79,3,15,11,0,152,1884.0
Agent_404,60,334,5,33,26,0,458,4444.0
Agent_404,39,319,5,22,23,2,410,5198.0
Agent_404,45,265,4,14,17,1,346,3032.0
Agent_404,48,278,3,10,10,2,351,2508.0
Agent_404,43,196,5,20,23,1,288,2322.0
Agent_404,47,322,4,21,26,1,421,4652.0
Agent_404,66,377,6,30,24,2,505,7380.0
Agent_404,37,167,4,13,15,0,236,2563.0
Agent_404,40,131,4,23,18,0,216,1481.0
Agent_404,39,239,3,31,12,0,324,1274.0
Agent_404,43,258,3,20,16,2,342,2650.0
Agent_404,41,270,3,16,11,0,341,1207.0
Agent_404,45,184,3,17,12,1,262,1337.0
Agent_404,56,132,4,15,13,0,220,2650.0
Agent_404,72,283,2,15,14,0,386,4224.0
Agent_404,70,301,3,16,15,1,406,3646.0
Agent_416,50,469,4,56,39,7,625,5890.0
Agent_416,47,156,3,18,14,5,243,1956.0
Agent_416,45,18,3,10,9,0,85,226.0
Agent_416,42,163,5,12,10,3,235,2281.0
Agent_416,59,313,2,27,13,2,416,3627.0
Agent_416,44,101,3,10,13,3,174,1203.0
Agent_416,33,225,2,17,12,4,293,2774.0
Agent_416,49,228,4,37,35,7,360,3233.0
Agent_416,73,573,4,37,42,9,738,13278.0
Agent_416,40,152,3,14,16,1,226,984.0
Agent_416,46,196,3,21,15,3,284,3744.0
Agent_416,54,401,2,26,22,4,509,5457.0
Agent_416,57,241,3,4,10,3,318,2738.0
Agent_416,49,280,4,20,20,1,374,5095.0
Agent_416,32,363,3,23,18,1,440,5460.0
Agent_416,47,121,3,16,14,0,201,2185.0
Agent_416,38,216,3,24,20,1,302,2835.0
Agent_416,39,207,3,17,19,5,290,1894.0
Agent_416,40,253,3,33,24,4,357,4224.0
Agent_416,48,125,3,14,14,3,207,1784.0
Agent_416,45,228,2,16,12,1,304,2890.0
Agent_416,50,207,3,15,15,0,290,2015.0
Agent_416,44,214,2,18,14,0,292,3306.0
Agent_416,46,396,1,37,21,3,504,4395.0
Agent_416,50,278,4,27,24,5,388,4693.0
Agent_416,47,147,3,14,9,4,224,1438.0
Agent_416,40,320,3,16,16,2,397,2118.0
Agent_416,54,450,2,35,27,4,572,9101.0
Agent_416,38,211,2,11,16,0,278,850.0
Agent_416,68,178,4,13,10,0,273,2685.0
Agent_434,36,219,8,37,21,1,322,2839.0
Agent_434,42,110,3,15,11,2,183,1413.0
Agent_434,42,183,4,40,14,1,284,3805.0
Agent_434,49,158,3,52,9,1,272,4019.0
Agent_434,49,109,3,9,8,2,180,3548.0
Agent_434,65,331,3,23,16,2,440,5380.0
Agent_434,44,407,3,58,23,5,540,7256.0
Agent_434,45,157,3,26,17,2,250,1643.0
Agent_434,42,575,3,52,16,2,690,5472.0
Agent_434,55,259,3,27,13,4,361,4150.0
Agent_434,38,311,4,80,17,1,451,3671.0
Agent_434,36,236,3,44,16,3,338,2494.0
Agent_434,46,67,3,20,6,1,143,601.0
Agent_434,47,24,3,16,10,1,101,461.0
Agent_434,42,213,5,46,16,1,323,3159.0
Agent_434,50,396,3,46,42,2,539,6388.0
Agent_434,36,137,3,49,9,0,234,763.0
Agent_434,40,65,4,32,11,0,152,1194.0
Agent_434,43,237,6,38,9,3,336,2383.0
Agent_434,43,325,4,37,24,1,434,4544.0
Agent_434,26,265,3,56,16,1,367,2808.0
Agent_434,44,349,3,87,24,5,512,8140.0
Agent_434,43,387,7,134,30,4,605,6913.0
Agent_434,36,149,4,33,15,1,238,1395.0
Agent_434,37,154,3,12,7,0,213,1899.0
Agent_434,40,197,8,36,11,2,294,3643.0
Agent_434,38,103,3,28,8,0,180,560.0
Agent_434,42,136,3,21,10,1,213,833.0
Agent_434,38,137,3,29,9,1,217,1185.0
Agent_434,45,148,4,41,14,3,255,1999.0
Agent_435,32,220,4,18,8,2,284,1827.0
Agent_435,40,139,3,22,9,0,213,1176.0
Agent_435,55,282,4,31,34,1,407,5700.0
Agent_435,38,237,6,38,18,0,337,5783.0
Agent_435,36,212,4,54,18,1,325,2481.0
Agent_435,52,182,3,14,11,0,262,4135.0
Agent_435,46,184,4,27,13,0,274,3694.0
Agent_435,39,182,3,36,19,0,279,3641.0
Agent_435,42,176,3,29,18,5,273,4205.0
Agent_435,65,208,5,15,11,1,305,3402.0
Agent_435,36,203,5,30,17,0,291,4282.0
Agent_435,54,383,5,23,19,5,489,5091.0
Agent_435,41,137,3,35,17,2,235,1224.0
Agent_435,44,206,3,31,13,0,297,2126.0
Agent_435,38,146,3,26,13,1,227,3406.0
Agent_435,40,153,3,18,11,1,226,687.0
Agent_435,36,108,3,19,14,2,182,724.0
Agent_435,45,228,5,20,15,3,316,5689.0
Agent_435,46,198,3,60,27,1,335,3344.0
Agent_435,46,219,3,34,18,2,322,1111.0
Agent_435,37,141,5,34,19,1,237,2065.0
Agent_435,54,188,4,36,22,1,305,3851.0
Agent_435,46,154,3,20,11,0,234,925.0
Agent_435,34,86,3,21,18,0,162,965.0
Agent_435,48,295,9,41,17,1,411,2724.0
Agent_435,48,346,3,47,42,2,488,5310.0
Agent_435,43,314,3,46,20,3,429,4043.0
Agent_435,48,246,3,17,16,3,333,3070.0
Agent_435,43,60,3,9,9,0,124,1051.0
Agent_435,43,255,4,33,18,4,357,2544.0
Agent_447,51,206,6,9,5,1,278,2653.0
Agent_447,38,151,6,8,10,3,216,1616.0
Agent_447,51,209,7,8,14,0,289,4681.0
Agent_447,41,215,6,5,7,1,275,3210.0
Agent_447,41,191,4,5,8,1,250,2493.0
Agent_447,37,386,5,7,27,1,463,4631.0
Agent_447,31,152,5,7,11,0,206,1473.0
Agent_447,39,235,5,10,10,3,302,2657.0
Agent_447,38,235,5,15,15,0,308,4250.0
Agent_447,33,105,7,5,11,1,162,585.0
Agent_447,39,335,8,20,21,2,425,6011.0
Agent_447,62,388,4,11,14,2,481,3525.0
Agent_447,31,253,7,8,11,2,312,2804.0
Agent_447,45,307,5,17,17,2,393,3945.0
Agent_447,42,340,7,17,14,1,421,3688.0
Agent_447,32,350,9,14,15,3,423,5285.0
Agent_447,41,545,8,14,26,4,638,5786.0
Agent_447,30,194,6,9,17,1,257,1339.0
Agent_447,35,211,4,14,12,2,278,2920.0
Agent_447,33,242,6,12,19,1,313,1962.0
Agent_447,44,358,6,7,16,5,436,5790.0
Agent_447,36,264,6,14,18,6,344,4623.0
Agent_447,34,271,6,12,21,0,344,3205.0
Agent_447,35,127,5,15,12,0,194,1411.0
Agent_447,38,146,8,5,8,2,207,2178.0
Agent_447,42,394,8,20,23,2,489,4493.0
Agent_447,37,64,4,7,8,0,120,451.0
Agent_447,37,152,6,10,12,0,217,2874.0
Agent_447,40,349,6,13,20,1,429,6441.0
Agent_447,28,237,7,13,13,3,301,1886.0
Agent_448,39,332,9,19,17,2,418,2867.0
Agent_448,39,368,9,18,28,2,464,4993.0
Agent_448,36,182,12,15,13,1,259,1945.0
Agent_448,32,403,9,25,27,2,498,4113.0
Agent_448,57,391,8,23,25,2,506,6690.0
Agent_448,28,304,8,19,19,2,380,3254.0
Agent_448,40,285,6,25,32,8,396,4126.0
Agent_448,49,166,6,13,9,1,244,3034.0
Agent_448,34,393,7,40,29,7,510,5288.0
Agent_448,37,188,7,12,11,1,256,2104.0
Agent_448,39,162,9,18,18,1,247,2374.0
Agent_448,30,159,7,15,16,3,230,2066.0
Agent_448,35,267,10,13,11,3,339,3931.0
Agent_448,38,164,8,19,20,1,250,4398.0
Agent_448,40,196,9,14,15,1,275,1663.0
Agent_448,38,201,7,17,14,1,278,2314.0
Agent_448,33,233,8,24,22,1,321,2571.0
Agent_448,40,171,6,12,15,0,244,2053.0
Agent_448,42,235,8,14,11,0,310,2724.0
Agent_448,41,274,9,28,22,3,377,3259.0
Agent_448,36,164,8,13,10,1,232,1407.0
Agent_448,42,347,7,32,28,4,460,4961.0
Agent_448,45,402,10,20,26,1,504,7794.0
Agent_448,58,175,6,14,16,1,270,2438.0
Agent_448,41,262,7,7,13,4,334,3663.0
Agent_448,38,97,7,12,13,0,167,1113.0
Agent_448,49,243,10,36,31,1,370,4233.0
Agent_448,33,344,7,27,20,1,432,5011.0
Agent_448,39,193,7,10,15,5,269,1997.0
Agent_448,32,224,8,26,19,0,309,4404.0
Agent_485,27,191,10,41,36,7,312,4299.0
Agent_485,36,246,12,51,26,28,399,3963.0
Agent_485,29,153,5,19,17,5,228,1644.0
Agent_485,34,287,3,49,30,9,412,2733.0
Agent_485,26,186,3,17,21,5,258,1436.0
Agent_485,31,239,4,31,24,7,336,2547.0
Agent_485,31,177,6,39,21,6,280,3100.0
Agent_485,30,400,8,54,47,12,551,4802.0
Agent_485,42,232,5,58,28,15,380,3457.0
Agent_485,37,180,4,35,25,6,287,3943.0
Agent_485,28,69,3,25,17,1,143,863.0
Agent_485,31,215,6,29,20,3,304,3684.0
Agent_485,23,257,8,49,40,12,389,5719.0
Agent_485,29,322,4,31,39,13,438,5765.0
Agent_485,29,300,12,34,28,5,408,3294.0
Agent_485,26,198,4,33,28,8,297,4184.0
Agent_485,31,351,5,33,42,5,467,6011.0
Agent_485,38,254,7,41,33,23,396,5361.0
Agent_485,32,266,6,48,31,15,398,4671.0
Agent_485,32,101,5,22,21,3,184,1617.0
Agent_485,58,346,9,74,54,15,556,12466.0
Agent_485,30,156,5,38,27,24,280,2676.0
Agent_485,34,414,12,47,39,9,555,8390.0
Agent_485,29,341,12,56,42,12,492,6613.0
Agent_485,30,161,7,26,22,4,250,1515.0
Agent_485,43,176,5,13,14,3,254,3852.0
Agent_485,38,297,9,38,33,18,433,4792.0
Agent_485,35,216,4,26,20,6,307,1732.0
Agent_485,34,123,4,20,16,4,201,1782.0
Agent_485,35,145,4,25,15,3,227,2387.0
Agent_486,31,387,13,56,64,7,558,4825.0
Agent_486,45,162,4,42,38,5,296,3286.0
Agent_486,25,230,6,47,26,9,343,1769.0
Agent_486,33,114,6,30,21,3,207,1354.0
Agent_486,35,102,3,18,18,5,181,1573.0
Agent_486,30,277,6,62,57,8,440,5125.0
Agent_486,35,410,7,49,39,8,548,4579.0
Agent_486,29,202,4,38,27,0,300,1676.0
Agent_486,29,80,3,30,20,4,166,1961.0
Agent_486,37,190,8,30,29,5,299,4528.0
Agent_486,28,214,6,39,35,12,334,2720.0
Agent_486,20,205,10,26,30,6,297,3273.0
Agent_486,28,338,12,66,53,10,507,6380.0
Agent_486,33,133,3,29,21,6,225,1954.0
Agent_486,37,225,7,48,39,9,365,3875.0
Agent_486,31,392,7,79,53,8,570,5127.0
Agent_486,31,113,5,26,17,1,193,2288.0
Agent_486,30,134,5,32,25,3,229,1767.0
Agent_486,31,238,9,39,24,2,343,4616.0
Agent_486,32,228,9,28,28,2,327,3573.0
Agent_486,26,114,3,29,16,1,189,478.0
Agent_486,32,232,5,43,29,13,354,3485.0
Agent_486,30,118,5,30,20,2,205,1291.0
Agent_486,38,383,5,49,25,12,512,4340.0
Agent_486,25,174,9,36,31,6,281,4427.0
Agent_486,29,262,7,49,34,12,393,4318.0
Agent_486,30,247,10,48,42,3,380,3048.0
Agent_486,27,46,6,32,16,0,127,442.0
Agent_486,31,229,7,51,39,1,358,3532.0
Agent_486,33,275,9,75,48,4,444,6787.0
Agent_487,36,111,6,30,36,3,222,3096.0
Agent_487,36,251,4,43,53,2,389,3390.0
Agent_487,31,198,9,43,35,2,318,3160.0
Agent_487,33,119,4,18,24,3,201,1375.0
Agent_487,40,318,11,60,53,8,490,5541.0
Agent_487,34,229,8,40,37,5,353,4288.0
Agent_487,32,133,5,31,27,9,237,1952.0
Agent_487,40,274,10,110,63,9,506,5232.0
Agent_487,36,105,4,31,29,4,209,1107.0
Agent_487,28,231,3,45,46,2,355,1307.0
Agent_487,31,246,5,54,44,3,383,2998.0
Agent_487,35,130,8,43,33,0,249,1385.0
Agent_487,31,276,6,60,82,6,461,4514.0
Agent_487,29,377,10,69,59,13,557,4991.0
Agent_487,30,87,9,25,22,2,175,1360.0
Agent_487,37,152,6,37,25,3,260,2619.0
Agent_487,34,173,6,37,35,9,294,3755.0
Agent_487,31,125,5,29,30,3,223,1458.0
Agent_487,40,228,7,54,35,12,376,5024.0
Agent_487,32,323,11,63,74,7,510,7602.0
Agent_487,32,255,5,39,42,8,381,3172.0
Agent_487,27,376,13,80,62,9,567,7251.0
Agent_487,37,265,5,44,51,6,408,4347.0
Agent_487,27,254,6,52,41,8,388,2882.0
Agent_487,28,217,5,47,44,9,350,3259.0
Agent_487,28,132,6,32,29,4,231,1787.0
Agent_487,41,138,6,48,46,2,281,3042.0
Agent_487,37,281,3,43,38,5,407,4951.0
Agent_487,33,141,8,40,35,1,258,1584.0
Agent_487,34,123,4,26,26,3,216,2397.0
